about = estivesse
Although I was about to cry ( Embora eu estivesse prester a chorar )
although = apesar
arousal = excitação
ashamed = envergonhado
awaited = aguardado 

blaze = chama
bare = ???
begged = implorou
beings = seres
belly = barriga
blink = piscar
bit = ???
boarding = embarque
bore = furo
bowed = curvado
bush = 

cage = gaiola
cheers = felicidades
cheered = aplaudido
chill = frio
couldn't = ???
creepy = assustador
crew = ???
crotch = virilha
crowd =  multidão

dare = ousar
deal = oferta
defenseless = indefeso
Despite = Apesar de
dirty = sujo
displeased = descontente 
dizzy = tonto
dozing = cochilando
dreadful = terrível

echoed = ecoado
eroded = erodido
Even = Par
Even though I was wearing clothes
( Mesmo usando roupas )

fadded = ???
faint = fraco
fare = tarifa
feel = sentir
feet = pés
felt = ?
filthy = imundo
flashed = piscou
footsteps = passos

gathered = reunidos
gazes = olha
glad = feliz
glued = colado
greedily = avidamente
grim =  sombrio
grinning = sorrindo
grunting = grunhindo
 
had = teve
I had never seen before 
( Eu nunca tinha visto isso antes )
harsh = 
Haven't = Não
Having = tendo
hear = ouvido 
heat = calor
heavier = mais pesado
hid =  ?
hopes = esperança
howls = uivo

if = ?

keepsake = lembrança
knees = joelhos
  
leash = trela
licked = lambeu
lips = lábios
looked = olhou
loud = alto
louder = mais alto
loudly = alto
lustfully = lascivamente

meant = significava
mercy = misericórdia
much = ?

naked = nu
nipples = mamilos

overbearing = autoritário

prey = presa
properly = corretamente
pussy = buceta
Please use my dirty pussy ( Por favor use minha buceta suja )

realize = ?
relived = revivido
roar = rugido
roasted = assado
rough = áspero

sat = ?
saw = vi
When I saw I finally got through the forest
( Quando vi , finalmente atravessei a floresta )
screaming = 
Seeing = Vendo
seemed = parecia
shaking = agitação
shameful = vergonhoso
shoulder = ombro
shown = mostrado
slave = escravo
smiled = sorriu 
smoke = fumaça
snorted = bufou
spoke = falou
He spoke in a very overbearing tone ( Ele falou em um tom muito autoritário )
spread = espalhar 
stand = ?
stood = ?
such = assim
suit = terno
sun = ?
supposed = supôs
struck = atingido
such = ?
swollen = inchado 

tasted = provado
their = deles
there = ?
thought = ?
threat = ameaça
thrived = prosperou
took = tomou
trembled = assumido
trembling = tremendo
trip = ?
troublesome = problemático 

waists = cinturas
warmth = calor
wasn't = ?
wearing = vestindo
wench = moça
were = ?
weren't = não eram
which = qual
while = ?
Who = Quem 
Whole = Todo 